1

30
50
..................................................
..................................................
..................................................
.....##############..............############.....
.....#.........#..#..............#..........#.....
.....#.#######.#.##..............#.########.#.....
.....#.#.....#....#..............#.#......#.#.....
.....#.#.#####.####..............#.#.####.#.#.....
.....#.#.....#...#################.#.##.#...#.....
.....#.#####.###........................#.#.#.....
.....#.........#.###############.#.##########.....
.....#########.#.#.#...........#.#..#.............
.............#.#.#.#...........###.##.............
.............#.#.#.#...........#....#.............
.............#.#...#...........#.##.#.............
.............#######...........#.##.#.............
.............#.................#.#..#.............
.............#.#################.####.............
.....#########...#.................##########.....
.....#.........###.#.#.##########.#######.#.#.....
.....#.#########.....#.#..........#.....#.#.#.....
.....#.#.........#####.##########.#.###.#.#.#.....
.....#.######.#####...........#.#.#.#.#.#.#.#.....
.....#......#.....#...........#.....#.#.#.#.#.....
.....#.##########.#...........#####.#.#.#.#.#.....
.....#............#...........#...........#.#.....
.....##############...........###############.....
..................................................
..................................................
..................................................
