1

26
42
..........................................
.##############..............############.
.#.........#..#..............#..........#.
.#.#######.#.##..............#.########.#.
.#.#.....#....#..............#.#......#.#.
.#.#.#####.####..............#.#.####.#.#.
.#.#.....#...#################.#.##.#...#.
.#.#####.###........................#.#.#.
.#.........#.###############.#.##########.
.#########.#.#.#...........#.#..#.........
.........#.#.#.#...........###.##.........
.........#.#.#.#...........#....#.........
.........###...#...........#.##.#.........
.........#.#####...........#.##.#.........
.........#.................#.#..#.........
.........#.#################.####.........
.#########...#.................##########.
.#.........###.#.#.##########.#######.#.#.
.#.#########.....#.#..........#.....#.#.#.
.#.#.........#####.##########.#.###.#.#.#.
.#.######.#####...........#.#.#.#.#.#.#.#.
.#......#.....#...........#.....#.#.#.#.#.
.#.##########.#...........#####.#.#.#.#.#.
.#............#...........#...........#.#.
.##############...........###############.
..........................................
